111111111111111
100P00000C000E1
101110111111101
10C000C010001C1
101110111110111
101000000000001
101110110110111
1C0C000C0001011
1000000C0000101
111111111111111