111111111111
100E0C000011
100000000P11
111111111111