11111111111111111111111111111
1E0000000000000C00000C0000111
10100101001000001P10010000111
10100100101010100010010000111
11111111111111111111111111111
